00002002000010000100
11102112011020110200
01002112000020000200
22122002221222122222
00100000000000020100
21201102222221120110
00200002000010010010
21222222212222221222
00000002000020010000
00111002011020020110